NO ./textures/env/village_wall.png
EA ./textures/env/village_wall.png
WE ./textures/env/village_wall.png
SO ./textures/env/village_wall.png

F 220,100,0
C 225,30,0

  11111121111111
 1100000000000011
110000000000000011
100000000000000001
100000000000000001
100000000000000001
100000000000000001
110000000000000011
 1100000000000011
  11000000000011
   111111011111
       10001
       10001
       10001
       10001
       10001
       10001
       10001
       10N01
       11211