NO textures/env/dungeon_wall.png
EA textures/env/dungeon_wall.png
WE textures/env/dungeon_wall.png
SO textures/env/dungeon_wall.png

F 220,100,0
C 225,30,0

    11111111111111111111111111111111111
    10000000000000000000000000000000001
    10000000000000000000000000000000001
    10000000000011110000111100000000001
    1000000000001  100001  100000000001
    1111111111111  100001  100000000001
                   100001  111111111111
1111111111111111111100001
1000000000000000000000001
2E00000000000000000000001
1000000000000000000000001  1111111111111111111111111
1111111111111111111100001  1000000000000000000000001
                   100001  1000000000000000000000001
                   100001  1000000000000000000000001
1111111111111111111100001  1000000000000000000000001
1000000000000000000100001111000000000000000000000001
1000000000000000000100000100000000000000000000000001
1000000000000000000100000200000000000000000000000001
1000000000000000000000000100000000000000000000000001
1000000000000000000000001111000000000000000000000001
1000000000000000000000001  1000000000000000000000001
1111111111111111111111111  1000000000000000000000001
                           1000000000000000000000001
                           1000000000000000000000001
                           1111111111111111111111111