NO ./textures/env/village_wall.png
EA ./textures/env/village_wall.png
WE ./textures/env/village_wall.png
SO ./textures/env/village_wall.png

F 220,100,0
C 225,30,0

1111111111111112111111111111111111
1000000000000000000000000000000001
1000000000000000000000000000000001
1000111111111111111111100000000001
1000200000000000000000200000000001
1000100000000000000000100000000001
1000100000000000000000100000000001
1000100000000000000000100000000001
1000111112111111111111100000000001
1000000000000000000000000000000001
1000000000000000000000000000000001
1000111111111100000000000000000001
1000100000000100000000011111000001
1000100000000100000000010001000001
1000100000000100000000020001000001
1000111112111100000000011111000001
1000000000000000000000000000000001
1000000000000000000000000000000001
1000000000000000000001111111111001
1000000000000000000001000000001001
1000000000000000000002000000001001
1000000000000000000001000000001001
1000000000000000000001111111111001
1000000000000000000000000000000001
1000000000000000N00000000000000001
1111111111111111211111111111111111