NO textures/image.png
EA textures/image.png
WE textures/image.png
SO textures/image.png

F 220,100,0
C 225,30,0

        1111111111111111111111111
        1000000000110000000000001
        1011000001110000000000001
        1001000000000000000000001
111111111011000001110000000000001
100000000011000001110000112110001
111101111111110111000000100010001
111101111111110111010100100010001
110000001101010111000000100020002
100000000000000020000000100011111
10000000000000001101010010001
11000001110101011111011110N0111
11110111 1110101 101111010001
11111111 1111111 111111111111
