NO textures/env/plain_wall.png
EA textures/env/plain_wall.png
WE textures/env/plain_wall.png
SO textures/env/plain_wall.png

F 220,100,0
C 225,30,0

     1                                               111
    101      1 1  1   1  1                          100011        1
  110001    11101101110110111111          1     11 10000001    1 101
  1000001111000000000000000011111   1    10111 1001000000001  10100011   11
  100000000000000000000000000121011101111000001000000000000011000000001110011
   100000000000000000000000000000000000000000000000000000000000000000000000001
  1000000000000000000000000000000000000000000000000000000000000000000000000001
  1000000000000000000000000000000000000000000000000000000000000000000000000001
 10000000000000000000000000000000000000000000000000000000000000000000000000001
 100000000000000000000000000000000000000000000000000000000000000000000000000001
  11000000000000000000000000000000000000000000000000000000000000000000000000001
  1000000000000000000000000000000000000000000000000000000000000000000000000001
  1000000000000000000000000000000000000000000000000000000000000000000000000011111
   100000000000000000000000000000000000000000000000000000000000000000000000111111
  1111000000000000000000000000000000000000000000000000000000000000000000000211111
 10000000000000000000000000000000000000000000000000000000000000000000000000111111
  1000000000000000000000000000000000000000000000000000000000000000000000000011111
  1110000000000000000000000000000000000000000000000000000000000000000000000001
 1000000000000000000000000000000000000000000000000000000000000000000000000011
100000000000000000000000000000000000000000000000000000000000000000000000000001
10000000000000000000000000000000000000000000000000000000000000000000000000001
 10000000000000000000000000000000000000000000000000000000000000000000000000001
  100000000000011111111000000000000000000000000000000000000000000000000000001
 11100000000001        1000000000000000000000000000000000000110000000000000001
 1000000000001          100000000000000010000000000100001111  100000000000011
  11000000001            100000000001101 1000111001 1101       11100000000001
    10000001              1000000001  1   101   11   11          110000000001
    1000001                100N0001        1                       11000000001
    1111111                11121111                                 1111111111
