NO textures/env/village_wall.png
EA textures/env/village_wall.png
WE textures/env/village_wall.png
SO textures/env/village_wall.png

F 220,100,0
C 225,30,0

111111111111112111111111111111
100000000000000000000000000001
100000000000000000000000000001
100000000000000000000000000001
100011111100000000000111110001
100010000100000000000100010001
100010000100000000000200010001
100010000100000000000100010001
100011211100000000000111110001
100000000000000000000000000001
100000000000000000000000000001
100000000000000000000000000001
100011121111001111211111111001
100010000001001000000000001001
100010000001001000000000001001
100010000001001000000000001001
100010000001001000000000001001
10001000N001002000000000002001
100010000001001000000000001001
100011111111001111111111111001
100000000000000000000000000001
100000000000000000000000000001
111111111111111111111111111111
