NO ./pd.jpg
SO ./pd.png
EA ./pd.jpg
WE ./pd.png

C 100,100,100
F 100,100,100

1111111
1N00001
1000001
1000001
1000001
1000001
1000001
1000001
1111111
