NO ./woodwall.png
SO ./brickwall.png
WE ./bluewall.png
E ./pebblewall.png

F 100,100,100
F 100,100,100

             11111111111111111111111111111111  1111 111111111111
             11100001100000000000000000000001111011 110000000001
             110000001000000000000000000000011110111111000000001
             100000001000000000000000000000010000000111000000001
             100000001000000000000000000000010000000111000000001
             100000000000000000000000000000000000000111110001111
             100000001000001111111111110001110000000110010001001
             100000001000001111111111000000010000000110010001001
             100000000000000000000001000000011111111110000000001
             100000001000000000000001000000011111111110010001001
             100000001000000000000001000000011000000111110001111
             110000001000000000000001000000011000000110010001001
             111000011000000000000001111111111000000110000000001
             111111111110001100011011111111111101100110010001001
1111111111111110000000010001100010001100000001000100111111011111
100000100010101111111111101110001000110000000100010010000000001 
100000000010101111111111000110001000110000000100010000000000001 
100000100010001000000001000110001000110000000100011110000000001 
100000100010001000000001000110001000110000000100011111111111111 
100000100011011000000001000110001000110000000100001000100010001 
100000100010001000000001000110001000110000000100001000100010001 
100000100010001000000001000110001000110000000100001000100010001 
100000100010001000000001000110001111110000001100001000100010001 
1000001000100010000000010001100010111111010110000011011101110111
1000001000100010000000010001100010100010000000000010000000000001
1000001000100010000000010001100010100000000000E00000000000000001
1000001000100010000000010001100010100010000000000010000000000001
1111111000100010000000010001100010111111010110000011011101110111
110000000010001111111111000110001111110000001100001000100010001 
 10000000010000000010001000110001000110000000100001000100010001 
 10000000010000000010001101110001000110000000100001000100010001 
 10001100010000000000001000110000000110000000100001000100010001 
 10001100010000000010001000110001000110000000100011111111111111 
 10001100010000000010001000111111111110000000100010000000000111 
 10001100011111111110001000111111111110000000100010000000000111 
 10001100010000000010001000111001011010000000100010000000000101 
110001100010000000010001000111000011011111100100010000000000001 
 100011000100000000100010001111110111111111111101111111111111011
 100011000100000000000010000010000000100000000000000000000000001
 100011000100000000100010000000000000000000000000000000000000001
 100011000100000000100010000010000000100000000000000000000000001
 100011000100000000100010001111110111111111111111111111111110001
 100011000111111111100010000001111100111111111111111111111110001
 100011000000000000100010001000011100100000100000010000000110001
 100011000000000000100010001111111111100000100000010000000110001
 100011000000000000000010001100000001100000100000000000000010001
 100011000000000000100010001100000001100000100000010000000000001
 100011000000000000100010001100000001100000100000010000000010001
1110111111111111111100011011100000001100000000000010000000110001
1000000000100000000100010001100000001100000100000010000000110001
1000000000110000000100010001000000001100000100000010000000010001
1000000000110000000100010000000000001100000100000010000000000001
1000000000110000000000010001000000001100000100000010000000010001
1000000000110000000100010001100000001100000100000010000000111111
1000000000110000000100010001100000001100000100000010000000111111
1000000000100000000100010001100000001100000100000010000000110001
1000000000111111111100010001100000001100000100000010000000110001
1000000000100000000100010001100000001100000000000010000000010001
1000000000100000000100010001100000001100000100000010000000000001
1000000000100000000000010001000000001100000100000010000000010001
1000000000100000000100000000000000001100000100000000000000110001
1000000000100000000100000001000000001100000100000010000000110101
1000000000111111111100000001100000001111010100000010000000111111
11111111111111111111111111111111111111111111111111111111111     
